######################################################################
#.........^^^^^^^^^^^^^^^^^..........................................#
#..............^^^^^^^^^.............................................#
#................^^^^^...............................................#
#....................................................................#
#....................................................................#
#....................................................................#
#................................^^^........^........................#
#.............................^^^^^^^^^^...^^^^......................#
#..........................^^^^^^^^^^^^^^^^^^^^^^^^^^................#
#.......................^^^^^^^^^^^^^^^^^^^^^^^^^^^^^^^..............#
######################################################################
